{
  "version": 1,
  "scene_code": "dungeon_01",
  "width": 16,
  "height": 16,
  "cell_size": 1.0,
  "layers": {
    "walkable": [
      0,0,0,0,0,0,0,0,0,0,0,0,0,0,0,0,
      0,1,1,1,1,1,1,1,1,1,1,1,1,1,1,0,
      0,1,1,1,1,1,1,1,1,1,1,1,1,1,1,0,
      0,1,1,1,1,1,1,0,0,1,1,1,1,1,1,0,
      0,1,1,1,1,1,1,0,0,1,1,1,1,1,1,0,
      0,1,1,1,1,1,1,0,0,1,1,1,1,1,1,0,
      0,1,1,1,1,1,1,1,1,1,1,1,1,1,1,0,
      0,1,1,1,0,0,0,1,1,1,0,0,0,1,1,0,
      0,1,1,1,0,0,0,1,1,1,0,0,0,1,1,0,
      0,1,1,1,0,0,0,1,1,1,0,0,0,1,1,0,
      0,1,1,1,1,1,1,1,1,1,1,1,1,1,1,0,
      0,1,1,1,1,1,1,1,1,1,1,1,1,1,1,0,
      0,1,1,1,1,1,1,1,1,1,1,1,1,1,1,0,
      0,1,1,1,1,1,1,1,1,1,1,1,1,1,1,0,
      0,1,1,1,1,1,1,1,1,1,1,1,1,1,1,0,
      0,0,0,0,0,0,0,0,0,0,0,0,0,0,0,0
    ],
    "block": [
      1,1,1,1,1,1,1,1,1,1,1,1,1,1,1,1,
      1,0,0,0,0,0,0,0,0,0,0,0,0,0,0,1,
      1,0,0,0,0,0,0,0,0,0,0,0,0,0,0,1,
      1,0,0,0,0,0,0,1,1,0,0,0,0,0,0,1,
      1,0,0,0,0,0,0,1,1,0,0,0,0,0,0,1,
      1,0,0,0,0,0,0,1,1,0,0,0,0,0,0,1,
      1,0,0,0,0,0,0,0,0,0,0,0,0,0,0,1,
      1,0,0,0,1,1,1,0,0,0,1,1,1,0,0,1,
      1,0,0,0,1,1,1,0,0,0,1,1,1,0,0,1,
      1,0,0,0,1,1,1,0,0,0,1,1,1,0,0,1,
      1,0,0,0,0,0,0,0,0,0,0,0,0,0,0,1,
      1,0,0,0,0,0,0,0,0,0,0,0,0,0,0,1,
      1,0,0,0,0,0,0,0,0,0,0,0,0,0,0,1,
      1,0,0,0,0,0,0,0,0,0,0,0,0,0,0,1,
      1,0,0,0,0,0,0,0,0,0,0,0,0,0,0,1,
      1,1,1,1,1,1,1,1,1,1,1,1,1,1,1,1
    ]
  },
  "aoi": {
    "block_size": 4
  }
}
